{
  "rows": 6,
  "cols": 6,
  "map": [
    ["E", "E", "E", "E", "E", "X"],
    ["E", "W", "W", "W", "E", "E"],
    ["E", "E", "R", "E", "E", "E"],
    ["E", "E", "E", "D", "E", "E"],
    ["E", "E", "E", "E", "E", "E"],
    ["E", "E", "E", "E", "E", "X"]
  ]
}
