{
  "rows": 6,
  "cols": 6,
  "map": [
    ["E", "E", "E", "E", "E", "X"],
    ["E", "R", "W", "W", "E", "E"],
    ["E", "E", "E", "W", "E", "E"],
    ["U", "E", "E", "W", "E", "E"],
    ["E", "E", "E", "E", "L", "E"],
    ["E", "E", "E", "E", "E", "X"]
  ]
}
