{
  "rows": 7,
  "cols": 7,
  "map": [
    ["E", "E", "E", "X", "E", "E", "E"],
    ["E", "W", "W", "W", "W", "W", "E"],
    ["E", "E", "E", "E", "E", "E", "E"],
    ["R", "E", "E", "U", "E", "E", "L"],
    ["E", "E", "E", "E", "E", "E", "E"],
    ["E", "W", "W", "W", "W", "W", "E"],
    ["E", "E", "E", "X", "E", "E", "E"]
  ]
}
