{
  "rows": 7,
  "cols": 7,
  "map": [
    ["E", "E", "E", "E", "E", "E", "X"],
    ["E", "W", "E", "W", "E", "W", "E"],
    ["R", "E", "E", "E", "E", "E", "E"],
    ["E", "W", "E", "W", "E", "W", "E"],
    ["D", "E", "E", "E", "E", "E", "L"],
    ["E", "W", "E", "W", "E", "W", "E"],
    ["E", "E", "E", "E", "E", "E", "X"]
  ]
}
